{
  "1": "355",
  "2": "356",
  "3": "357",
  "4": "358",
  "5": "359",
  "6": "360",
  "7": "361",
  "8": "362",
  "9": "363",
  "10": "364",
  "11": "365"
}